LilBot	KEYWORD1
Bot	KEYWORD1
wait	KEYWORD2
emote	KEYWORD2
emoteByNumber	KEYWORD2
go	KEYWORD2
rotate	KEYWORD2
sound	KEYWORD2
say	KEYWORD2
start	KEYWORD3
balance	KEYWORD3
blankFace	LITERAL1
afraid	LITERAL1
amused	LITERAL1
angry	LITERAL1
blissful	LITERAL1
cool	LITERAL1
crying	LITERAL1
disappointed	LITERAL1
embarrassed	LITERAL1
happy	LITERAL1
impatient	LITERAL1
naughty	LITERAL1
neutral	LITERAL1
nonplussed	LITERAL1
outraged	LITERAL1
proud	LITERAL1
resigned	LITERAL1
sad	LITERAL1
sarcastic	LITERAL1
shocked	LITERAL1
smiling	LITERAL1
verySad	LITERAL1
winking	LITERAL1
frontObstacleHandler	KEYWORD2
rightObstacleHandler	KEYWORD2
leftObstacleHandler	KEYWORD2
edgeHandler	KEYWORD2
